#F#####
#.....#
#.###.#
##S.#.#
#...#.#
#.#...#
#######